1 1 1 1 1 1 1 1 1 1 1 1 1 1 1 1 1 1 1 1 1 1 1 1 1 1 1 1 1 1 
1 0 0 0 1 1 0 0 0 1 0 1 0 0 1 0 1 0 1 1 0 1 0 0 0 0 0 1 1 1 
1 1 0 0 0 1 0 0 0 1 0 0 1 1 0 1 0 0 0 1 0 1 0 0 0 0 1 1 1 1 
1 0 0 0 0 0 0 1 0 1 1 1 0 0 0 0 0 0 0 0 0 0 0 0 0 0 0 0 0 1 
1 0 1 0 0 1 0 1 1 1 0 0 1 1 0 0 1 0 0 1 1 1 0 0 0 0 0 1 1 1 
1 0 0 0 0 0 0 0 0 0 1 1 1 0 1 1 0 0 1 0 1 0 1 1 0 0 0 0 1 1 
1 1 0 0 0 0 1 0 0 1 1 1 0 0 1 0 1 0 0 0 0 0 1 0 0 0 1 0 1 1 
1 1 0 0 0 1 1 0 0 0 1 0 0 0 1 1 0 0 1 1 0 1 0 0 0 1 0 0 0 1 
1 1 0 0 0 0 1 0 1 1 1 1 0 0 0 0 0 0 1 0 0 1 0 0 1 0 1 1 0 1 
1 0 0 0 0 0 0 1 1 0 1 0 0 0 0 0 0 0 0 0 1 0 0 0 1 0 0 1 1 1 
1 1 0 1 0 0 1 1 0 1 0 0 0 0 0 1 0 0 1 0 0 0 0 0 1 0 0 1 1 1 
1 0 0 0 0 1 1 1 1 1 0 1 1 0 0 0 0 1 1 1 0 1 1 0 0 0 0 1 0 1 
1 1 1 1 0 0 0 1 0 0 0 0 0 0 0 0 1 0 0 0 0 0 1 0 0 0 1 0 0 1 
1 0 0 0 0 1 0 0 1 1 0 0 1 0 0 0 1 0 1 0 0 0 0 0 0 0 0 1 1 1 
1 0 0 1 1 0 0 0 0 0 0 0 0 0 1 0 1 0 0 1 1 0 1 1 0 0 0 1 1 1 
1 0 1 0 0 1 1 0 0 1 0 1 0 1 1 3 0 0 0 0 0 0 1 1 1 0 1 0 0 1 
1 1 0 0 1 1 1 0 1 0 1 0 0 1 0 3 1 0 1 0 0 0 0 1 1 1 0 0 1 1 
1 0 1 1 1 1 1 1 0 0 0 0 0 0 0 3 0 0 1 1 0 1 1 1 1 0 1 0 0 1 
1 0 0 1 1 1 0 0 0 1 0 0 1 0 0 3 0 1 0 0 0 0 0 0 1 0 0 1 0 1 
1 1 1 0 0 1 0 0 1 0 0 0 0 0 0 4 4 4 3 0 0 0 0 1 1 1 1 0 0 1 
1 0 1 0 0 0 1 0 0 0 0 1 0 0 0 1 1 1 3 1 0 0 0 0 1 0 1 0 0 1 
1 0 0 1 1 0 1 0 0 0 0 0 0 0 0 0 0 0 3 0 0 0 1 0 0 0 0 0 0 1 
1 1 0 0 1 0 0 0 0 1 0 0 0 0 1 0 0 1 4 3 1 0 0 0 0 1 0 0 1 1 
1 0 0 1 0 0 0 0 0 0 0 0 0 0 0 0 0 1 1 3 0 1 1 0 0 0 0 1 0 1 
1 0 0 0 0 0 0 1 0 0 0 0 0 0 0 0 3 5 5 3 0 0 0 1 1 0 1 0 1 1 
1 1 0 1 1 0 0 1 1 1 0 1 1 0 0 0 3 4 6 3 0 1 0 1 0 0 0 0 0 1 
1 0 0 0 0 0 1 0 0 1 0 0 0 0 1 3 5 6 3 5 1 0 1 0 0 0 0 0 1 1 
1 0 0 0 0 0 1 1 0 0 0 0 0 0 0 3 1 6 3 1 0 1 0 1 0 0 0 0 0 1 
1 0 0 0 1 1 1 1 0 1 0 0 1 0 1 3 0 6 5 2 1 0 0 1 1 0 0 1 0 1 
1 1 1 1 1 1 1 1 1 1 1 1 1 1 1 7 1 1 1 1 1 1 1 1 1 1 1 1 1 1 
